4 1 0 0 1 4 4 4 4 4 4 4 4 4 4 4
4 1 0 0 1 1 1 1 1 1 3 3 3 3 3 4
4 1 0 0 1 1 3 1 1 1 3 1 1 1 3 4
4 1 0 0 0 0 0 0 1 1 1 1 3 1 3 4
4 1 0 0 0 0 0 0 1 1 1 1 1 1 1 4
4 1 1 1 3 1 0 0 1 1 1 3 1 3 3 4
4 1 1 1 1 1 0 0 1 1 1 1 1 1 1 4
4 2 2 2 2 2 2 2 2 2 2 2 2 1 3 4
4 2 5 5 5 5 2 2 2 2 2 2 2 2 1 4
4 5 5 5 5 5 5 5 5 5 5 2 2 2 2 1
4 5 5 5 5 5 5 5 5 5 5 5 2 2 2 2
4 4 4 4 4 4 4 4 4 4 4 4 1 2 2 2